English

string sEditorMode          = "Editor Mode";
string sEditorModeSimple    = "Simple";
string sEditorModeAdvanced  = "Advanced";
string sEditorModePreset    = "Preset";
    string sHelpSimple      = "In this mode, you can easily edit the appearance.";
    string sHelpAdvanced    = "In this mode, you can make detailed settings for the material.";
    string sHelpPreset      = "In this mode, you can easily set up materials from presets.";



string sColor           = "Color";
string sGamma           = "Gamma";
string sHue             = "Hue";
string sSaturation      = "Saturation";
string sValue           = "Value";
string sStrength        = "Strength";
string sStrengthMask    = "Mask & Strength";
string sStrengthR       = "Strength (R)";
string sTexture         = "Texture";
string sTextureRGBA     = "Color (RGB) and Transparency (A)";
string sMask            = "Mask";
string sBlendR          = "Blend (R)";
string sBlendMode       = "Blending Mode";
string sBlendModeNormal = "Normal";
string sBlendModeAdd    = "Add";
string sBlendModeScreen = "Screen";
string sBlendModeMul    = "Multiply";
string sBorder          = "Border";
string sBorderAO        = "AO & Border";
string sBorderR         = "Border (R)";
string sBlur            = "Blur";
string sBlurR           = "Blur (R)";
string sAlphaR          = "Alpha (R)";
string sUseMainColorSO  = "Use Main Color";
string sMainColorPower  = "Main Color Power";
string sBlendLight      = "Blend Light";
string sUVSetting       = "UV Setting";
string sUVAnimation     = "UV Animation";
string sScroll          = "Scroll";
string sAngle           = "Angle";
string sRotate          = "Rotate";
string sAsDecal         = "As Decal";
string sDecalAnimation  = "Animation|X Size|Y Size|Frames|FPS";
string sDecalSubParam   = "Ratio X|Ratio Y|Fix Border";
string sConvertGif      = "Convert Gif";
string sMirrorMode      = "Mirror Mode";
    string sMirrorModeNormal    = "Normal";
    string sMirrorModeFlip      = "Flip";
    string sMirrorModeLeft      = "Left Only";
    string sMirrorModeRight     = "Right Only";
    string sMirrorModeRightFlip = "Flip Right Only";
string sCopyMode        = "Copy Mode";
    string sCopyModeNormal      = "Normal";
    string sCopyModeSymmetry    = "Symmetry";
    string sCopyModeFlip        = "Flip";
string sPositionX       = "Position X";
string sPositionY       = "Position Y";
string sScaleX          = "Scale X";
string sScaleY          = "Scale Y";
string sVector          = "Vector";
string sLength          = "Length";

string sReset           = "Reset";

string sLimShadowStrength   = "Shadow Strength";
string sLimOutline          = "Outline";
string sLimEmission         = "Emission";
string sLimEmission2nd      = "Emission 2nd";



string sBaseSetting = "Base Setting";
    string sInvisible                   = "Invisible";
    string sShaderType                  = "Shader Tyoe";
    string sShaderTypeNormal            = "Normal";
    string sShaderTypeLite              = "Lite";
    string sRenderingMode               = "Rendering Mode";
    string sRenderingModeOpaque         = "Opaque";
    string sRenderingModeCutout         = "Cutout";
    string sRenderingModeTransparent    = "Transparent";
    string sRenderingModeAdd            = "Add";
    string sRenderingModeMultiply       = "Multiply";
    string sRenderingModeRefraction     = "Refraction";
    string sRenderingModeRefractionBlur = "Refraction Blur";
    string sRenderingModeFur            = "Fur";
    string sRenderingModeFurCutout      = "Fur Cutout";
    string sCutoff                      = "Cutoff";
    string sCullMode                    = "Cull Mode";
    string sCullModeOff                 = "Off";
    string sCullModeFront               = "Front";
    string sCullModeBack                = "Back";
    string sFlipBackfaceNormal          = "Flip Backface Normal";
    string sBackfaceForceShadow         = "Backface Force Shadow";
    string sHelpRenderingTransparent    = "When two transparent materials overlap, one of them may become invisible.";
    string sHelpCullMode                = "If the material does not look right, set the CullMode to Off or Back.";
    string sHelpZWrite                  = "If the material does not look right, turn on ZWrite.";
    string sMaskTiling                  = "Mask UV Tiling";
    string sMaskOffset                  = "Mask UV Offset";
    string sTriMask                     = "TriMask (Mat/Rim/Emi)";
    string sTriMaskRGB                  = "Mask (R:Matcap G:Rim B:Emission)";



string sColors = "Color";
    string sMainColor           = "Main Color";
        string sMainColorTips       = "You can set the color and transparency.";
        string sUseMainColor        = "Main Color";
        string sUseMainColor2nd     = "Main Color 2nd";
        string sUseMainColor3rd     = "Main Color 3rd";
    string sShadow              = "Shadow";
        string sShadowTips          = "You can set the color and range of the shadow.";
        string sUseShadow           = "Shadow";
        string sReceiveShadow       = "Receive Shadow";
        string sShadowColor         = "ShadowColor";
        string sShadow1stColor      = "1st Color";
        string sShadow2ndColor      = "2nd Color";
        string sShadowEnvStrength   = "Environment Strength";
        string sShadowBorderColor   = "Border Color";
        string sShadowBorderRange   = "Border Range";
    string sOutline             = "Outline";
        string sOutlineTips         = "You can set the color and thickness of the outline.";
        string sUseOutline          = "Outline";
        string sWidth               = "Mask & Width";
        string sWidthR              = "Width (R)";
    string sRefraction          = "Refraction";
        string sRefractionTips      = "You can set the refraction strength and color.";
        string sRefractionLabel     = "Refraction";
        string sRefractionStrength  = "Strength";
        string sRefractionFresnel   = "Fresnel";
        string sRefractionColorFromMain  = "Refraction Color From Main";
    string sFur                 = "Fur";
        string sFurTips             = "You can set the length and direction of the fur.";
        string sFurLabel            = "Fur";
        string sFurNoise            = "Noise";
        string sFurNoiseR           = "Noise (R)";
        string sFurGravity          = "Gravity";
        string sFurAO               = "AO";
        string sVertexColor2FurVector   = "VertexColor -> Vector";
        string sFurLayerNum         = "Layer";
    string sTessellation        = "Tessellation";
        string sTessellationTips    = "You can set the tessellation.";
        string sTessellationEdge    = "Threshold length";
        string sTessellationShrink  = "Shrink";
        string sTessellationFactor  = "Max Factor";
    string sEmission            = "Emission";
        string sEmissionTips        = "You can set the color and blinking of the light.";
        string sUseEmission         = "Emission";
        string sUseEmission2nd      = "Emission 2nd";
        string sBlinkStrength       = "Blink Strength";
        string sBlinkType           = "Blink Type";
        string sBlinkSpeed          = "Blink Speed";
        string sBlinkOffset         = "Blink Offset";
        string sUseGrad             = "Gradation";
        string sGradTexSpeed        = "Texture & Speed";
        string sGradColor           = "Color";
        string sParallaxDepth       = "Parallax Depth";
        string sFluorescence        = "Fluorescence";
    string sParallax            = "Parallax";
        string sParallaxTips        = "You can set the parallax.";
        string sParallaxR           = "Parallax (R)";
        string sParallaxOffset      = "Offset";



string sNormalReflection    = "Normal & Reflection";
    string sNormal              = "Normal Map";
        string sNormalTips          = "You can set the normal map.";
        string sUseNormalMap        = "Normal Map";
        string sUseNormalMap2nd     = "Normal Map 2nd";
        string sNormalMap           = "Normal Map";
        string sNormalRGB           = "Normal (RGB)";
    string sReflections         = "Reflections";
        string sReflectionsTips     = "You can set the Reflections.";
        string sUseReflection       = "Reflection";
        string sSmoothness          = "Smoothness";
        string sSmoothnessR         = "Smoothness (R)";
        string sMetallic            = "Metallic";
        string sMetallicR           = "Metallic (R)";
        string sSpecularMode        = "Specular Mode";
        string sSpecularNone        = "None";
        string sSpecularReal        = "Realistic";
        string sSpecularToon        = "Toon";
        string sApplyReflection     = "Environment Reflections";
        string sUseCubemap          = "Cubemap";
        string sCubemap             = "Cubemap";
        string sSelectCubemap       = "Select Cubemap";
        string sUseMatCap           = "MatCap";
        string sMatCap              = "MatCap";
        string sMatCapMul           = "Multiply";
        string sUseRim              = "Rim Light";
        string sFresnelPower        = "Fresnel Power";
        string sShadowMask          = "Shadow Mask";
    string sStencil             = "Stencil";
        string sStencilTips         = "You can set the Stencil";



string sAdvanced = "Advanced";
string sRendering = "Rendering";
    string sRenderingTips               = "You can configure detailed rendering settings.";
    string sZWrite                      = "ZWrite";
    string sZTest                       = "ZTest";
    string sSrcBlend                    = "SrcBlend";
    string sDstBlend                    = "DstBlend";
    string sBlendOp                     = "BlendOp";
    string sSrcBlendForwardAdd          = "ForwardAdd SrcBlend";
    string sDstBlendForwardAdd          = "ForwardAdd DstBlend";
    string sBlendOpForwardAdd           = "ForwardAdd BlendOp";
    string sRenderingReset              = "Reset Rendering Properties";



string sOptimization = "Optimization";
    string sOptimizationTips    = "You can optimize the material to reduce the load.";
    string sBake                = "Bake";
    string sBakeAll             = "Bake all layer";
    string sBake1st             = "Bake Color Shift";
    string sBake2nd             = "Bake 2nd Layer";
    string sBake3rd             = "Bake 3rd layer";
    string sBakeAlphamask       = "Bake Alphamask";
    string sSelectAlphamask     = "Select Alphamask";
    string sRemoveUnused        = "Remove unused textures";
    string sConvertLite         = "Convert to lilToonLite";
    string sConvertMToon        = "Convert to MToon (VRM)";



string sPresets                     = "Presets";
string sPresetRefresh               = "Refresh List";
string sPresetSave                  = "Save Preset";
string sPresetCategory              = "Category";
string sPresetCategorySkin          = "Skin";
string sPresetCategoryHair          = "Hair";
string sPresetCategoryCloth         = "Cloth";
string sPresetCategoryNature        = "Nature";
string sPresetCategoryInorganic     = "Inorganic";
string sPresetCategoryEffect        = "Effect";
string sPresetCategoryOther         = "Other";
string sPresetName                  = "Name";
string sPresetSaveTarget            = "Save target";
string sPresetTexture               = "Save target texture";
string sPresetShader                = "Shader";
string sPresetQueue                 = "Render Queue";
string sPresetStencil               = "Stencil";
string sPresetMain                  = "Main Color";
string sPresetMain2                 = "Main Color 2nd";
string sPresetMain2Mask             = "Main Color 2nd Mask";
string sPresetMain3                 = "Main Color 3rd";
string sPresetMain3Mask             = "Main Color 3rd Mask";
string sPresetShadowBorder          = "Shadow AO";
string sPresetShadowBlur            = "Shadow Blur";
string sPresetShadowStrength        = "Shadow Mask";
string sPresetShadowColor           = "Shadow Color";
string sPresetShadowColor2          = "Shadow Color 2nd";
string sPresetOutlineWidth          = "Outline Width";
string sPresetEmissionColor         = "Emission Color";
string sPresetEmissionMask          = "Emission Mask";
string sPresetEmissionGrad          = "Emission Grad";
string sPresetEmission2Color        = "Emission 2nd Color";
string sPresetEmission2Mask         = "Emission 2nd Mask";
string sPresetEmission2Grad         = "Emission 2nd Grad";
string sPresetNormal                = "Normal Map";
string sPresetNormal2               = "Normal Map 2nd";
string sPresetNormal2Mask           = "Normal Map 2nd Mask";
string sPresetReflectionSmoothness  = "Smoothness";
string sPresetReflectionMetalic     = "Metalic";
string sPresetReflectionColor       = "Reflection Color";
string sPresetMatcap                = "MatCap";
string sPresetMatcapMask            = "MatCap Mask";
string sPresetRim                   = "Rim Color";
string sPresetParallax              = "Parallax";
string sPresetFurNormal             = "Fur Normal";
string sPresetFurNoise              = "Fur Noise";
string sPresetFurMask               = "Fur Mask";